11111111111111111111
1P00000000011110C101
11101C11110000101101
11C11110111110000001
11000010000010110111
11011010111010110111
11111010011000010111
10000011011110110111
1000011000C110110001
11110000000110111101
11110111100110000011
1111C000001111111111
11111111100000000011
1000C111101111100111
101111111011111000C1
10110000000001110001
100001110111000C11E1
11111111111111111111
